--- Glossário para uso na Tradução do Star Citizen ---

=================================================== Termos ===================================================
Advocacy - Advocacia
Advocacy Description - Descrição da Advocacia
Agricultural Supply - Suprimento Agrícola
Airlock - Câmara a Vácuo
Airlock=câmara de vácuo
Alloy - Liga
Ammo Box - Caixa de Munição
Ammo Case - Estojo de Munição
Ancillary casualties - Vítimas secundárias
Multi-Tool - Multi-Ferramenta
Attachment - Anexo - Fixação - Acessório
Attachment Point - Ponto de Fixação
Barrel - Cano
Beacon - Farol? - Sinalizador?
blue-on-blue - Fogo Amigo
Boost - Impulso
Bounties - Caçadas
Bounty Hunters Guild - Guilda dos Caçadores de Recompensas
Checkpoint - Ponto de Controle - Marcadores
Claim - Reivindicar - Solicitar
Claimjumpers - ?
Claimjumpers - Invasores
Cloudrest Retreat - Cloudrest Retreat
Cloudrest Retreat - Retiro nas Nuvens
Cockpit - Cabine
Combat Fighter - Caça de Combate
Comm Array - Satélite
Comm Uplink - Comm Uplink
Commlink - Commlink
Commodity - Mercadorias
CompSec - ???
Consumer Goods - Bens de Consumo
Contract Manager - Gerenciador de Contratos
Contractors - Contratados - Contratantes
Contractor - Contratado - Contratante
Cooler System - Sistema de Resfriamento
Cooling System - Sistema de Refrigeração
Courier Assignment - Serviço de Entrega
Couriers - Entregadores
Crew - Tripulação
Crimestat - Status Criminal
Criminal Record - Ficha Criminal
cryopod - cryopod
CRYPTOKEY - CRIPTOCHAVE
Datapad - Datapad
Deck - Plataforma
Deck - ÁREA
Decline - Recusar
Decoy - Decoy
Deductible - Franquia
Deliver - Entregar
Disabled - Desabilitado / Desativado
DISPATCH - DISTRIBUIÇÃO
Docking - Docagem
Enabled - Habilitado / Ativado
Environmental Hazard - Perigo Ambiental
Flash Hider - Freio de Boca
Fleet Manager - Gerenciador de Frota
Freight - Frete
FUNT (fast and untraceable) - RENR (rápido e não rastreável)
Gadget - Dispositivo
Gimbal - Giroscópio
Group - Canal
group_invite_group_to_party - Convidar Canal para Grupo
group_invite_party_to_group - Convidar Grupo para Canal
Heavy - Pesado
ICU - UTI
ICU - UTI
Invite - Convidar
Journal - Jornal
Jump Drive - Motor de Salto
Jump Point - Ponto de Salto
jump seat - assento retrátil
Kiosk - Quiosque
Landing Pad - Plataforma de Pouso
Landing Services - Serviço de Pouso
Landing System - Sistema de Pouso
Light - Leve
Light Fighter - Caça Leve
Light Freight - Frete Leve
Livery - Pintura
lobby - saguão
Magazine Capacity - Capacidade do Carregador
Magazine Size - Tamanho do Carregador
Manufacturer - Fabricante
Match - Partida - Jogos - Organização - Combinação
Matchmaking - Organização de Partidas
Medical Supply - Suprimentos Médicos
Medium - Médio
Merits: Méritos
Nonmetals - Não metais
Nose Mount - Suporte do Nariz
Nudge - Deslocar
orbital sentries - sentinelas orbitais
Ore - Minério
Outcasts - Párias - Foragidos - Forasteiros
Outlaw's - Foras da Lei - Criminosos
Party - Grupo
Passkey - Chave de Acesso
Pathfinder - Desbravador
PDC Monitors - Monitores PDC
Plasma Fuel - Combustível de Plasma
Power Plant - Gerador energia
Power Source - Fonte de Energia
Power Supply - Suprimento de Energia
QUANTUM DAMPENER - IMPEDIMENTO QUÂNTICA
Quantum Drive - Motor Quântico
Quantum Fuel - Combustível Quântico
QUANTUM SNARE - ARMADILHA QUÂNTICA
Quantum Travel - Viagem Quântica
Quartz - Quartzo
Refueling - Reabastecimento
Relocate - Realocar
Remaining Sites of Hostiles - Locais Restantes de Inimigos
Requeue - Reenfileiramento
Restocking - Reestocando / Remuniciando
Retrieve - Retirar - Recuperar
Rock - Rocha
ROE - RDE (relativo a Regras de Engajamento (Rules of Engagement))
Run - Corrida - Entrega (Quando está no contexto de entregas de mercadorias.)
Rush Contract - Contrato Urgente
Salvage Yard - Área de Sucateamento
Scan Mode - Modo Scan
Scrap - Sucata
Selenium - Selênio
Self-Destruct - Auto-Destruição
shield = Escudo
Shipment - Transporte
Shipment Coordinator - Coordenador de Transporte - Coordenador de Embarque - Coordenador de Remessa - Coordenador de Expedição
Silicon - Silício
Site - Local
Skimmer - Drone
Skyline - Skyline
Skyline - Skyline
Sodium - Sódio
Spawn - Nascimento
Sprint - Corrida
StarMap - Mapa Estelar
station lobby - saguão da estação
Steel - Aço
Stileron - Estilete
Stims - Estimulantes
Store - Armazenar
strafe - deslocar-se
Strafe Down - Deslocar (para baixo)
Strafe Up - Deslocar (para cima)
Sulfer Moss - Musgo Sulfer
Supply - Suprimento
systems-grok - Gênio em sistemas
Tacit Supressor - Supressor Tácito
Taranite - Taranita
Target - Alvo
Tellurium - Telúrio
Thorium - Tório
Thruster - Propulsor
Thrusters - Propulsores
Tin - Estanho
Tin Ore - Minério de Estanho
Titanium - Titânio
Tracker Beginner's Permit - Permissão de Rastreador Iniciante
Tritium - Trítio
Tungsten - Tungstênio
Uplink - Uplink
Upload - Carregamento
Uranium - Urânio
Vehicle Loadout Manager - Gerenciador de Equipamento dos Veículos
Warning - Alerta
Waste - Resíduos
SUICIDE SCRAMBLE - LUTA SUICIDA - Confusão Suicida ?
hatjob - chapeleiro
Klescher Rehabilitation Facilities - Instalações de Reabilitação Klescher
Log out - Sair p/ menu
holster - Guardar (coldre é apenas para pistola)
Optics - Lente
Bounty Hunting - Caça à Recompensa - Coleta de Recompensas(para missões)
courier - entregador - transportador
Pickup - Coleta/r, Retira/r
Drop off - Entrega/r, Descartar
site - local
wreck site - local dos destroços
wreck - destroços
Recover - Recupere


----------------------------------------------- Armadura -----------------------------------------------
Arms = Braços
Core = Torso
Exploration Suit = Traje de Exploração
Helmet = Capacete
Jumpsuit - Macacão
Legs = Pernas
Loadout - Equipamento
Slot - Slot
Underbarrel - Slot Inferior
Undersuit - Sub Traje

----------------------------------------------- Armas -----------------------------------------------
Distortion Scattergun = Espingarda de Distorção
Laser Repeater - Repetidor Laser
Mass Driver - Acelerador de Massa (como em Mass Driver Cannon)

----------------------------------------------- Frases -----------------------------------------------
big score - grande golpe
Group Warrant Issued - Mandado de Grupo Emitido
Liaison Officer Vanzant - Oficial de Contato Vanzant
over-achieving - super-ultrapassados
Protect Site Trial Contract - Contrato de Teste: Proteja o local
score - um golpe

----------------------------------------------- Empresas -----------------------------------------------
BlacJac Security - BlacJac Security
Covalex Shipping - Covalex Shipping
Crusader Security - Crusader Security
ECKHART SECURITY - ECKHART SECURITY
FTL Courier Services - FTL Courier Services
RED WIND LINEHAUL - RED WIND LINEHAUL

----------------------------------------------- Naves -----------------------------------------------
Bomber - Bombardeiro
Capital Ship - Nave Capital
CapShip - NavCap (Capital Ship)
Corvette - Corveta
Courier - Entregador
Destroyer - Destróier
Dropship - Transporte de Tropas
Expedition - Expedição
Frigate - Fragata
Gunship - Guerra
Mining - Mineração
Salvage - Sucateiro
Refuelling - Abastecimento
Repair - Reparador
Science - Ciencia
Pathfinder - Desbravador
Stealth - furtivo
Interceptor - Interceptador

----------------------------------------------- Planetas/Cidades/Locais -----------------------------------------------
ArcCorp - ArcCorp
Area18 - Área18
Baijini Point - Baijini Point
Lorville - Lorville
Lorville - Lorville
Orison - Orison

----------------------------------------------- Navegação -----------------------------------------------
Aft - Popa/Traseiro
Front - Proa/Frontal
Nadir - Inferior/Abaixo
Port - Bombordo
Starbord - Estibordo
Zenith - Superior/Acima
----------------------------------------------- Termos Militares -----------------------------------------------
What's your twenty? - Qual a sua localização? (referente ao código 10-20)